+--+--+--+--+
|     p     |
+  +--+--+  +
|  |e    |  |
|  +--+  |  |
|           |
+  +--+--+  +
|    e|     |
+  +--+--+  +
|           |
+--+--+--+--+

