+--+--+--+--+
|     p     |
+  +--+--+  +
|  |e    |  |
|  +---+d|  |
|           |
+  +--+--+  +
|  d e|  d  |
+  +--+--+  +
|           |
+--+--+--+--+

