+-----------+
|     p     |
|  +-----+  |
|  |     |  |
|  +---+d|  |
|           |
|  +-----+  |
|  d  |g d  |
|  +-----+  |
|   e       |
+-----------+

