+-----------+
|     p e   |
|  +-----+  |
|  |e    |  |
|  +---+d|  |
|           |
|  +-----+  |
|  d e|  d  |
|  +-----+  |
|           |
+-----------+

