+-----------+
|g          |
|--+-----+  |
|  |  p  |  |
|  +---+d|+d|
|        |  |
|--d-----+  |
|       e|  |
|  +-----+  |
|        d  |
+-----------+

