+-----------+
|g          |
|--+-----+  |
|  |  p  |  |
|  +---+d|  |
|        |  |
|-+d+----+  |
|       e|  |
|  +-----+  |
|           |
+-----------+

