+-----------+
|         g |
|-----d-----|
|+         +|
|     e     |
|+         +|
|           |
|+         +|
|           |
|   | p |   |
+-----------+

